9
0 5 10 0 0 0 15 0 0 
0 0 5 8 6 0 0 0 0 
0 0 0 10 0 0 0 0 0 
0 0 0 0 0 15 0 0 8 
0 0 0 0 0 4 0 0 0 
0 0 0 0 0 0 0 0 20 
0 0 0 0 0 0 0 15 0 
0 0 0 0 0 0 0 0 6 
0 0 0 0 0 0 0 0 0
